"Original Keys in Fitness Order (Best First)","Hand (Right = 0)","Row","Pos"
"j",0,1,6
"f",1,1,3
"k",0,1,7
"d",1,1,2
"l",0,1,8
"s",1,1,1
"ò",0,1,9
"a",1,1,0
"h",0,1,5
"g",1,1,4
"u",0,0,6
"r",1,0,3
"y",0,0,5
"t",1,0,4
"I",0,0,7
"e",1,0,2
"o",0,0,8
"w",1,0,1
"p",0,0,9
"q",1,0,0
"m",0,2,7
"c",1,2,3
"n",0,2,6
"v",1,2,4
"b",0,2,5
",",0,2,8
"x",1,2,2
".",0,2,9
"z",1,2,1
"-",0,2,10
"<",1,2,0
"à",0,1,10
"è",0,0,10
"ù",0,1,11
"+",0,0,11
